s+++++++++w
w   w    +w
w w w w  +w
w   w w  +w
w w w w  +w
w   w    +w
w w w w  +w
w   w    +w
w w w w  +w
w        +w
w w w w  +w
wwwwwwwww+e